######################################
#....................................#
#....................................#
#....................................#
#.......@............................#
#....................................#
#....................................#
#....................................#
#....................................#
#....................................#
#..............###.###...............#
#..............#.....#...............#
#..............#.....#...............#
#....................................#
#..............#.....#...............#
#..............#.....#...............#
#..............###.###...............#
#....................................#
#....................................#
#....................................#
#....................................#
#....................................#
#....................................#
#....................................#
#....................................#
#....................................#
#....................................#
######################################