                                      
 #################################### 
 #..................................# 
 #..................................# 
 #.......@..........................# 
 #..................................# 
 #..................................# 
 #..................................# 
 #..................................# 
 #..................................# 
 #............###.###...............# 
 #............#.....#...............# 
 #............#.....#...............# 
 #..................................# 
 #............#.....#...............# 
 #............#.....#...............# 
 #............###.###...............# 
 #..................................# 
 #..................................# 
 #..................................# 
 #..................................# 
 #..................................# 
 #..................................# 
 #..................................# 
 #..................................# 
 #..................................# 
 #################################### 
                                      